11111111111111111111111
100000000000000000001E1
100000000000000C1111001
10000000000000000000001
11111111110000000000001
1P000000000000111111111
10000000111001010000001
11111111111111111111111
