1111111111111111
1E000000C00C0001
1010010100100001
1010010010101011
1P0000000C00C001
1111111111111111