1111111111111111
1E00000001010101
1000000110101010
100000000000C001
1P11110111010101
1111111111111111