11111111111
1000C00C0C1
1P0001110E1
11111111111