1111111
11000E1
1P0C111
1111111